                 #######################################                   
      ###########.....................................######              
      #....................................................#####          
      #........................................................#          
     ##........................................................########## 
     #..................................................................# 
     #..................................................................# 
     #..................................................................# 
    ##..................................................................# 
#####...................................................................# 
#.......................................................................# 
#.......................................................................# 
#.......................................................................# 
#.......................................................................# 
#.......................................................................# 
#.......................................................................# 
#.......................................................................# 
#.......................................................................# 
#.......................................................................##
#........................................................................#
#........................................................................#
#........................................................................#
#........................................................................#
#........................................................................#
#........................................................................#
#........................................................................#
#........................................................................#
#........................................................................#
#........................................................................#
#........................................................................#
#........................................................................#
#........................................................................#
#........................................................................#
#........................................................................#
#........................................................................#
###......................................................................#
  #......................................................................#
  #......................................................................#
  #......................................................................#
  #......................................................................#
  #......................................................................#
  #...............................................................########
  ####............................................................#       
     #............................................................#       
     #.........................................................####       
     #.........................................................#          
     #.........................................................#          
     #................................##########################          
     #................................#                                   
     #................................#                                   
     #................................#                                   
     ##################################                                   

