          ################################                                     
      ####..............................######################################
  #####......................................................................#
  #..........................................................................#
  #..........................................................................#
  #..........................................................................#
###..........................................................................#
#............................................................................#
#............................................................................#
#............................................................................#
#............................................................................#
#............................................................................#
#............................................................................#
#............................................................................#
#............................................................................#
#............................................................................#
#............................................................................#
#............................................................................#
#............................................................................#
#............................................................................#
#............................................................................#
#............................................................................#
#............................................................................#
#.......................................................................######
#.......................................................................#     
#.......................................................................#     
#.......................................................................#     
#.......................................................................#     
#.......................................................................#     
#.......................................................................#     
#.......................................................................#     
#.......................................................................#     
#.......................................................................#     
#.......................................................................#     
#.......................................................................#     
##......................................................................#     
 #......................................................................#     
 #......................................................................#     
 #......................................................................#     
 #......................................................................#     
 #......................................................................#     
 #......................................................................#     
 #......................................................................#     
 #......................................................................#     
 #......................................................................#     
 #......................................................................#     
 #......................................................................#     
 ####...................................................................#     
    #####...............................................................#     
        #...............................................................#     
        #...........................................#####################     
        #############################################                         

