                                                                                                                                 ##########################################                                                            
                                                                                                                                 #........................................#                                                            
                                                                                                                                 #........................................#                                                            
                                                                                                                                 #........................................#         #############################################      
                                                                                                                                 #........................................#         #...........................................#      
                                                                                                                              ####........................................#         #...........................................#      
                                                         #########################################                            #...........................................#         #...........................................#      
                                  ########################.......................................#                            #...........................................#         #...........................................#      
  #################################..............................................................#                            #...........................................###########...........................................#      
  #..............................................................................................#                            #.................................................................................................#      
  #..............................................................................................###############              #.................................................................................................#      
  #............................................................................................................#              #.................................................................................................#      
  #............................................................................................................#              #.................................................................................................#      
  #............................................................................................................########       #.................................................................................................#      
  #...................................................................................................................#       #.................................................................................................#      
  #...................................................................................................................#       #.................................................................................................#      
  #...................................................................................................................#       #.................................................................................................#      
  #...................................................................................................................#       ####..............................................................................................#      
  #...................................................................................................................#          #..............................................................................................#      
  #...................................................................................................................#  #########..............................................................................................#      
  #...................................................................................................................####......................................................................................................#      
  #.............................................................................................................................................................................................................................#      
  #.............................................................................................................................................................................................................................#      
  #..................................................................................................................................................................................................................############      
  #..................................................................................................................................................................................................................#                 
  #..................................................................................................................................................................................................................#                 
  #..................................................................................................................................................................................................................#                 
  #..................................................................................................................................................................................................................#                 
  #..................................................................................................................................................................................................................#                 
  #..................................................................................................................................................................................................................#                 
  #.................................................................######...........................................................................................................................................#                 
  #..................................................................................................................................................................................................................#                 
  #..................................................................................................................................................................................................................#                 
  ################..................................#####............................................................................................................................................................#                 
                 #..................................#   #............................................................................................................................................................#                 
                 #..................................#   #...............................................###.#........................................................................................................#                 
##################..................................#   #............................................................................................................................................................#                 
#...................................................#   #............................................................................................................................................................#                 
#...................................................#   #............................................................................................................................................................#                 
#...................................................#   #..................................................................................................###.......................................................#                 
#...................................................#   #..................................................................................................# #.......................................................#                 
#...................................................#####..................................................................................................# #.......................................................#                 
#......................................................###################.................................................................................# #.......................................................#                 
#......................................................#           #.......................................................................................# #.......................................................#                 
#......................................................#############.......................................................................................# #.......................................................#                 
#..........................................................................................................................................................# #.......................................................#                 
#......................................................#############.......................................................................................# #.......................................................#                 
#.........................................................#        #...................................................................................##### #.......................................................#                 
#.........................................................#  #######...................................................................................#     #..................................######################                 
#.........................................................#  #.........................................................................................#     #..................................#                                      
#.........................................................#  #.........................................................................................#     #..................................#                                      
#.........................................................#  #.........................................................................................#     #..................................#                                      
#.........................................................#  #.........................................................................................#     #..................................#                                      
#.........................................................#  #.........................................................................................#     #..................................#                                      
#.........................................................#  #.........................................................................................#     #..................................#                                      
#################.........................................#  #.........................................................................................#     #..................................#                                      
                #.........................................#  #................................................................................#################################.#####################                                  
                #.........................................#  #######................................................................................................................................#                                  
                #.........................................#        ###..............................................................................................................................#                                  
                ####......................................#          #..............................................................................................................................#                                  
                   #......................................#          ###############................................................................................................................###############                    
                   #......................................#                        #..............................................................................................................................#                    
                   #......................................#      ###################..............................................................................................................................#                    
            ########......................................#      #................................................................................................................................................#                    
            #.............................................########................................................................................................................................................#####################
            #.........................................................................................................................................................................................................................#
            #.........................................................................................................................................................................................................................#
            #.........................................................................................................................................................................................................................#
    #########.........................................................................................................................................................................................................................#
    #.................................................................................................................................................................................................................................#
    #.................................................................................................................................................................................................................................#
    #.................................................................................................................................................................................................................................#
    #.................................................................................................................................................................................................................................#
    #.................................................................................................................................................................................................................................#
    #.................................................................................................................................................................................................................................#
    #............................................#################....................................................................................................................................................................#
    #............................................#               #....................................................................................................................................................................#
    #............................................#               #....................................................................................................................................................................#
    #............................................#               #....................................................................................................................................................................#
    #............................................#               #....................................................................................................................................................................#
    #............................................#               #....................................................................................................................................................................#
    #............................................#               ###################.....................................###############...................................#################..........................................#
    #............................................#                                 #######################################             #...................................#               #..........................................#
    #............................................#                                                                                     #...................................#               #..........................................#
    #............................................#                                                                                     #...................................#               #..........................................#
    #............................................#                                                                                     #...................................#               #..........................................#
    #............................................#                                                                                     #...................................#               #..........................................#
    ##############################################                                                                                     #...................................#               #..........................................#
                                                                                                                                       #...................................#               #..........................................#
                                                                                                                                       #...................................#               #..........................................#
                                                                                                                                       #...................................#               ############################################
                                                                                                                                       #...................................#                                                           
                                                                                                                                       #...................................#                                                           
                                                                                                                                       #...................................#                                                           
                                                                                                                                       #...................................#                                                           
                                                                                                                                       #...................................#                                                           
                                                                                                                                       #...................................#                                                           
                                                                                                                                       #####################################                                                           

