                                                                                                                                                         ########################################                                    
                                                                                                                                                         #......................................#                                    
                                                                                          ############################################                   #......................................#                                    
                                                                                          #..........................................#                   #......................................#                                    
                                                                                          #..........................................#                   #......................................#                                    
                                                                                          #..........................................##############      #......................................#                                    
                                                           ################################.......................................................#      #......................................#                                    
                                                           #......................................................................................#      #......................................#                                    
                                                           #......................................................................................#      #......................................#                                    
                                                           #......................................................................................#      #......................................#############################        
              ##############################################......................................................................................#      #..................................................................#        
              #...................................................................................................................................#      #..................................................................#        
              #...................................................................................................................................#      ####################.#########.....................................#        
              #...................................................................................................................................#                        # . #      #.....................................#        
              #...................................................................................................................................#                        # . #      #.....................................#        
              #...................................................................................................................................#                        # . #      #.....................................#        
              #...................................................................................................................................#                        # . #      #.....................................#        
              #...................................................................................................................................#                        # . #      #.....................................#        
              #...................................................................................................................................#                        # . #      #.....................................#        
###############...................................................................................................................................#                        # . #      #.....................................#        
#.................................................................................................................................................#                        # . #      #.....................................#        
#.................................................................................................................................................######################   # . #      #.....................................#        
#......................................................................................................................................................................#   # . #      #.....................................#        
#......................................................................................................................................................................#   # . #      #.....................................#        
#............................................................########..................................................................................................#   # . #      #.....................................#        
#............................................................########..................................................................................................#   # . #      #.....................................#        
#......................................................................................................................................................................#   # . #      #.....................................#        
#......................................................................................................................................................................#   # . #      #.....................................#        
#......................................................................................................................................................................#   # . #      #.....................................#        
#......................................................................................................................................................................#   # . #      #.....................................#        
#......................................................................................................................................................................#   # . #      #.....................................#        
#......................................................................................................................................................................######.### #####.....................................######   
#...............................................................................................................................................................................# #..............................................#   
#...............................................................................................................................................................................###..............................................#   
#................................................................................................................................................................................................................................#   
#................................................................................................................................................................................................................................#   
#................................................................................................................................................................................................................................#   
#................................................................................................................................................................................................................................#   
#................................................................................................................................................................................................................................##  
#.................................................................................................................................................................................................................................#  
#............................#######..............................................................................................................................................................................................#  
##############################     #..............................................................................................................................................................................................#  
                                   #..............................................................................................................................................................................................#  
                         ###########............................................................................................................................................###...............................................#  
                         #......................................................................................................................................................# #...............................................#  
                         #......................................................................................................................................................# #...............................................#  
                         #......................................................................................................................................................# #...............................................#  
                         #...............................................#......................................................................................................# #...............................................#  
                         #.........................................#######............................................#.........................................................###...............................................#  
                         #.........................................#     #............................................############................................................................................................#  
                         #.........................................#     #............................................#          #................................................................................................#  
                         #.........................................#     #............................................############................................................................................................#  
                         #.........................................#     #........................................................................................................................................................#  
       ###################.........................................#     #........................................................................................................................................................#  
       #...........................................................#     #........................................................................................................................................................#  
       #...........................................................#     #........................................................................................................................................................#  
       #...........................................................#     #........................................................................................................................................................#  
       #.....................................#.#####################     #..........................................................................................................#.............................................#  
       #.......................................#                         #..........................................................................................................#.............................................###
       #.....................................###                  ########..........................................................................................................#####...........................................#
       #.....................................#                    #.................................................................................................................#   #...........................................#
 #######.....................................#                    #.................................................................................................................#   #...........................................#
 #...........................................#                    #.................................................................................................................#   #...........................................#
 #................................############                    #.................................................................................................................#   #...........................................#
 #................................#                               #.................................................................................................................#   #...........................................#
 #................................#                               #.................................................................................................................#   #...........................................#
 #................................#                               #.................................................................................................................#   #...........................................#
 #................................#############################   #.................................................................................................................#   #...........................................#
 #............................................................#####..........................................###....................................................................#   #...........................................#
 #...........................................................................................................# #....................................................................#   #...........................................#
 #............................................................................#..............................# #....................................................................#   #...........................................#
 #............................................................................#..............................# #....................................................................#   #...........................................#
 #............................................................................#..............................# #....................................................................#   #...........................................#
 #............................................................................#..............................# ##########################...........................................#   #...........................................#
 #............................................................................#..............................#                          #...........................................#   #...........................................#
 #............................................................................#..............................#                          #...........................................#   #...........................................#
 #............................................................................#..............................#                          #...........................................#   #...........................................#
 #............................................................................#..............................#                          #...........................................#   #...........................................#
 #............................................................................#..............................#                          #############################################   #...........................................#
 #............................................................................#..............................#                                                                          #...........................................#
 #............................................................................#..............................#                                                                          #...........................................#
 #............................................................#################..............................#                                                                          #############################################
 #................................#############################               #..............................#                                                                                                                       
 #................................#                                           #..............................#                                                                                                                       
 #................................#                                           #..............................#                                                                                                                       
 ##################################                                           ################################                                                                                                                       

