       ###############################                                   
       #.............................#                                   
       #.............................########################            
     ###....................................................#####        
     #..........................................................#########
     #..................................................................#
     #..................................................................#
######..................................................................#
#.......................................................................#
#.......................................................................#
#.......................................................................#
#.......................................................................#
#.......................................................................#
#.......................................................................#
#.......................................................................#
#.......................................................................#
#.......................................................................#
#.......................................................................#
#.......................................................................#
#.......................................................................#
#.......................................................................#
#.......................................................................#
#.......................................................................#
##......................................................................#
 #......................................................................#
 #......................................................................#
 #......................................................................#
 #......................................................................#
 #......................................................................#
 #......................................................................#
 #......................................................................#
 #......................................................................#
 #..............................................................#########
 #..............................................................#        
 #..............................................................#        
 #..............................................................#        
 #..............................................................#        
 #..............................................................#        
 #..............................................................#        
 #.............................................................##        
 #............................................................##         
 #............................................................#          
 ####.........................................................#          
    #.........................................................#          
    #.........................................................#          
    #.........................................................#          
    #.........................................................#          
    ##############...........................................##          
                 #...............................#############           
                 #...............................#                       
                 #...............................#                       
                 #################################                       

