                                               #########################################                                                                                                                                     
 ######################################        #.......................................#                                                                                                                                     
 #....................................##########.......................................#                                                                                                                                     
 #.....................................................................................#                                                                                                                                     
 #.....................................................................................#                                                                                                                                     
 #.....................................................................................#                                                                                                                                     
 #.....................................................................................#                                                                                                                                     
 #.....................................................................................##                     ##################################                                                                             
 #......................................................................................#                     #................................#          ####################################                               
 #......................................................................................##                    #................................#          #..................................#                               
 #...................................................................................... #                    #................................#          #..................................#                               
 #...................................................................................... #                    #................................############..................................################################
 #...................................................................................... #                    #.............................................................................................................#
 #......................................................................................##################    #.............................................................................................................#
 #.......................................................................................................######.............................................................................................................#
 #..........................................................................................................................................................................................................................#
 #..........................................................................................................................................................................................................................#
 #..........................................................................................................................................................................................................................#
 #..........................................................................................................................................................................................................................#
 #..........................................................................................................................................................................................................................#
 #..........................................................................................................................................................................................................................#
 #..........................................................................................................................................................................................................................#
 #..........................................................................................................................................................................................................................#
 #..................................................................................................................................................................................................................#########
 #..................................................................................................................................................................................................................#        
 #..................................................................................................................................................................................................................#        
 #...............................................##################.................................................................................................................................................#        
 ######........................................................#  #.................................................................................................................................................#        
      #################........................................#  #.................................................................................................................................................#        
                      #........................................#  #.................................................................................................................................................#        
                      #........................................####.................................................................................................................................................#        
                      #.............................................................................................................................................................................................#        
          #############.............................................................................................................................................................................................#        
          #.........................................................................................................................................................................................................#        
          #.........................................................................................................................................................................................................#        
          #.........................................................................................................................................................................................................#        
          #......................................................................................................................................................................................####################        
          #......................................................................................................................................................................................#                           
          #......................................................................................................................................................................................####################        
          #.........................................................................................................................................................................................................#        
          #.........................................................................................................................................................................................................#        
          #.........................................................................................................................................................................................................#        
          #.........................................................................................................................................................................................................#        
          #.........................................................................................................................................................................................................#        
          #.........................................................................................................................................................................................................#        
###########.......................................................................................................................########################..........................................................#        
#.................................................................................................................................#                      #..........................................................#        
#.................................................................................................................................#                      #..........................................................#        
#.................................................................................................................................#                      #..........................................................#        
#.................................................................................................................................#                      #..........................................................#        
#.................................................................................................................................#                      #..........................................................#        
#...............................................................................................................................###                      #..........................................................#        
#...............................................................................................................................#                        #..........................................................#        
#..............................................................................................................################## ############################......................................................#        
#..............................................................................................................#                  #.................................................................................#        
#...........................................##.................................................................#                  #.................................................................................#        
#..............................................................................................................#                  #.................................................................................#        
#..............................................................................................................#                  #.................................................................................#        
#..............................................................................................................#                  #.................................................................................#        
#..............................................................................................................#                  #.................................................................................#        
#..............................................................................................................#                  #.................................................................................#        
#..............................................................................................................#                  #.................................................................................#        
##.............................................................................................................#                  #.................................................................................#        
 #.............................................................................................................#                  #.................................................................................#        
 #.............................................................................................................#                  #.................................................................................#        
 #.............................................................................................................#                  #.................................................................................#        
 #.............................................................................................................#                  ##########.................................................................########        
 #...........................................................................................................###                           #.................................................................#               
 #...........................................................................................................#                             #.................................................................#               
 #.................................................................................###########################                             #.................................................................#               
 #.................................................................................#                                                       #.................................................................#               
 #.................................................................................#                                                       #.................................................................#               
 #.................................................................................#                                                       #.......................................................###########               
 #.................................................................................#                                                       #.......................................................#                         
 #.................................................................................#                                                       #.......................................................#                         
 #.................................................................................#                                                       ###############.........................................#                         
 #.................................................................................#                                                                     #.........................................#                         
 #.....................................................................#############                                                                     ########...............................####                         
 #.............................................#########################                                                                                        #...............................#                            
 #.............................................#                                                                                                                #...............................#                            
 #.............................................#                                                                                                                #################################                            
 #.............................................#                                                                                                                                                                             
 #.............................................#                                                                                                                                                                             
 #.............................................#                                                                                                                                                                             
 #.............................................#                                                                                                                                                                             
 #############.................................#                                                                                                                                                                             
             #.................................#                                                                                                                                                                             
             #.................................#                                                                                                                                                                             
             #.................................#                                                                                                                                                                             
             ###################################                                                                                                                                                                             

