                                                                                                                                             ###############################################                                                  
                                                                                                                                             #.............................................#                                                  
                                                                                                                                             #.............................................#                                                  
###############################################################################################################                              #.............................................#                                                  
#.............................................................................................................##################             #.............................................#                                                  
#..............................................................................................................................#             #.............................................#                                                  
#..............................................................................................................................#             #.............................................#                                                  
#..............................................................................................................................#             #.............................................#                                                  
#..............................................................................................................................#             #.............................................#######################                            
#..............................................................................................................................#             #...................................................................#                            
#..............................................................................................................................#             #...................................................................#                            
#..............................................................................................................................###############...................................................................#                            
#............................................................................#######.............................................................................................................................#                            
##############################...............................................#     #.............................................................................................................................#                            
                    #........................................................#     #.............................................................................................................................#                            
                    #........................................................#     #.............................................................................................................................#                            
                    #........................................................#######.............................................................................................................................#                            
                    #............................................................................................................................................................................................#                            
                    #............................................................................................................................................................#########.#######################                            
                    #............................................................................................................................................................#      # . #                                                 
                    #............................................................................................................................................................#      # . #                                                 
                    #............................................................................................................................................................#      # . #                                                 
                    #............................................................................................................................................................#      # . #                                                 
                    #............................................................................................................................................................#########.##                                                 
                    #.......................................................................................................................................................................#                                                 
                    #.......................................................................................................................................................................#                                                 
                    #.......................................................................................................................................................................#                                                 
                    #.......................................................................................................................................................................#                                                 
                    #.......................................................................................................................................................................######################                            
                    ####.........................................................................................................................................................................................#                            
                       #.........................................................................................................................................................................................#                            
                       #.........................................................................................................................................................................................#                            
                       #.........................................................................................................................................................................................#                            
                       #.........................................................................................................................................................................................#                            
                       #...........................................................####..........................................................................................................................#                            
                       #.........................................................................................................................................................................................#############################
                     ###.....................................................................................................................................................................................................................#
                     #.......................................................................................................................................................................................................................#
                     #.......................................................................................................................................................................................................................#
                     #.......................................................................................................................................................................................................................#
                     #.......................................................................................................................................................................................................................#
                     #.......................................................................................................................................................................................................................#
                     #.......................................................................................................................................................................................................................#
                     #.......................................................................................................................................................................................................................#
                     #................................................................................................................................................#########..............................................................#
                     #................................................................................................................................................#       #..............................................................#
                     #................................................................................................................................................#########..............................................................#
                     #.............................................................###################.......................................................................................................................................#
                     #.............................................................# #################.......................................................................................................................................#
######################.............................................................# #.......................................................................................................................................................#
#..................................................................................# #.......................................................................................................................................................#
#..................................................................................# #................................................................................................................................................########
#..................................................................................# #................................................................................................................................................#       
#..................................................................................# #................................................................................................................................................#       
#..................................................................................# #................................................................................................................................................#       
#..................................................................................# #................................................................................................................................................#       
#..................................................................................# #................................................................................................................................................#       
#..................................................................................# #................................................................................................................................................#       
#...................................................................################ #................................................................................................................................................#       
#........................................................................#           #................................................................................................................................................#       
######################...................................................#           #................................................................................................................................................#       
                     #...................................................#           #........................................###.....................................................................................................#       
       ###############...................................................#           #........................................# #.....................................................................................................#       
       #.................................................................#           #........................................# #.....................................................................................................#       
       #.................................................................#           #........................................###.....................................................................................................#       
       #.................................................................#           #..........................................................................................#######...............................................#       
       #.................................................................#   #########..........................................................................................#     #...............................................#       
       #.................................................................#   #..................................................................................................#     #################################################       
       #.................................................................#   #..................................................................................................#                                                             
       #.................................................................#   #..................................................................................................#                                                             
       #.................................................................#   #..................................................................................................#                                                             
       #.................................................................#   #..................................................................................................#                                                             
       #.................................................................#   #..................................................................................................#                                                             
       #.................................................................#   #..................................................................................................#                                                             
       #.................................................................#   #........................................#################.........................................#                                                             
       ##############.................................................####   #........................................#               ###########################################                                                             
                    #.................................................#      #........................................#                                                                                                                       
                    #............................................######      #........................................#                                                                                                                       
                    #............................................#           #........................................#                                                                                                                       
                    #............................................#           #........................................#                                                                                                                       
                    #............................................#           #........................................#                                                                                                                       
                    #............................................#           #........................................#                                                                                                                       
                    #............................................#           #........................................#                                                                                                                       
                    #############................................#           #........................................#                                                                                                                       
                                #................................#           #........................................#                                                                                                                       
                                #................................#           #........................................#                                                                                                                       
                                #................................#           #........................................#                                                                                                                       
                                #................................#           #........................................#                                                                                                                       
                                #................................#           #........................................#                                                                                                                       
                                #................................#           #........................................#                                                                                                                       
                                ##################################           #........................................#                                                                                                                       
                                                                             #........................................#                                                                                                                       
                                                                             ##########################################                                                                                                                       

