                  ##################################################         
  ################................................................#         
###...............................................................##        
#..................................................................#        
#..................................................................#########
#..........................................................................#
#..........................................................................#
#..........................................................................#
#..........................................................................#
#..........................................................................#
#..........................................................................#
#..........................................................................#
#..........................................................................#
#..........................................................................#
#..........................................................................#
#..........................................................................#
#..........................................................................#
#..........................................................................#
#..........................................................................#
#..........................................................................#
#..........................................................................#
#..........................................................................#
#..........................................................................#
#..........................................................................#
#..........................................................................#
#.......................................................................####
#.......................................................................#   
#.......................................................................#   
#.......................................................................#   
#.......................................................................#   
#.......................................................................#   
#.......................................................................#   
#.......................................................................#   
##......................................................................#   
 #......................................................................#   
 #......................................................................#   
 #......................................................................#   
 #......................................................................#   
 #......................................................................#   
 #......................................................................#   
 #......................................................................#   
 #......................................................................#   
 ###....................................................................#   
   #....................................................................#   
   #....................................................................#   
   #....................................................................#   
   #....................................................................#   
   #....................................................................#   
   #....................................................................#   
   ######################################################################   

