    ###################################                                     
   #.................................#####################                 
   #.....................................................#                 
   #.....................................................#                 
 ###.....................................................#                 
 #.......................................................#                 
 #.......................................................#                 
 #.......................................................#                 
 #.......................................................################  
 #......................................................................#  
 #......................................................................#  
 #......................................................................#  
 #......................................................................#  
 #......................................................................#  
 #......................................................................#  
##......................................................................#  
#.......................................................................#  
#.......................................................................###
#.........................................................................#
#.........................................................................#
#.........................................................................#
#.........................................................................#
#.........................................................................#
#.........................................................................#
#.........................................................................#
#.........................................................................#
#.........................................................................#
#.........................................................................#
#.........................................................................#
#.........................................................................#
#.........................................................................#
#.........................................................................#
#.........................................................................#
#.........................................................................#
#.........................................................................#
#.........................................................................#
#.........................................................................#
#.........................................................................#
##........................................................................#
 #.....................................................................####
 #.....................................................................#   
 ###...................................................................#   
   #...................................................................#   
   #...................................................................#   
   #...................................................................#   
   #...................................................................#   
   #...................................................................#   
   #....................................................################   
   #....................................................#                  
   #...................................................##                  
   #...................................................#                   
   #########...........................................#                   
           ############..............................###                   
                      ################################                     

