                       ############################################           
                      #..........................................#           
    ###################..........................................#           
    #............................................................#           
    #............................................................#           
    #............................................................#           
    #............................................................#           
    #............................................................#           
#####............................................................#           
#................................................................#           
#................................................................#           
#................................................................#           
#................................................................#           
#................................................................#           
#................................................................#           
#................................................................#           
#................................................................############
####........................................................................#
  ##........................................................................#
  #.........................................................................#
  #.........................................................................#
  #.........................................................................#
  #.........................................................................#
  #.........................................................................#
  #.........................................................................#
  #.........................................................................#
  #.........................................................................#
  #.........................................................................#
  #..............................................................############
  #..............................................................#           
  #..............................................................#           
  #..............................................................#           
  #..............................................................#           
  #..............................................................#           
  #..............................................................#           
  #..............................................................#           
  #..............................................................#           
  #..............................................................#           
  ######.........................................................#           
       #.........................................................#           
       #.........................................................#           
       ###.......................................................#           
         #.......................................................#           
         #.......................................................#           
         #.....................................................###           
         #.....................................................#             
         #.....................................................#             
         #.....................................................#             
         #.....................................................#             
         #.....................................................#             
         #.....................................................#             
         #................................................######             
         #................................................#                  
         #................................................#                  
         #................................................#                  
         #................................................#                  
         ##################################################                  

