                               ########################################                            
################################......................................#                            
#.....................................................................#                            
#.....................................................................#                            
#.....................................................................#                            
#.....................................................................#########                    
#.............................................................................#                    
#.............................................................................#                    
#.............................................................................#                    
#.............................................................................#                    
#.............................................................................#                    
##########....................................................................#################### 
         #.......................................................................................##
         #........................................................................................#
 #########........................................................................................#
 #................................................................................................#
 #................................................................................................#
 #................................................................................................#
 #................................................................................................#
 #................................................................................................#
 #................................................................................................#
 #................................................................................................#
 #................................................................................................#
 #................................................................................................#
 #................................................................................................#
 #................................................................................................#
 #................................................................................................#
 #................................................................................................#
 #................................................................................................#
 #................................................................................................#
 #................................................................................................#
 #................................................................................................#
 #................................................................................................#
 #................................................................................................#
 #................................................................................................#
 #...............................................................................................##
 #...............................................................................................# 
 #..................................................................................############## 
 #.........................................................................................#       
 #.........................................................................................#       
 #.........................................................................................#       
 #.........................................................................................#       
 #.........................................................................................#       
 #.........................................................................................#       
 #.........................................................................................#       
 #.........................................................................................#       
 #.........................................................................................#       
 #.........................................................................................#       
 #.........................................................................................######  
 #..............................................................................................#  
 #..............................................................................................#  
 #..............................................................................................#  
 #..............................................................................................#  
 #..............................................................................................#  
 #..............................................................................................#  
 #..............................................................................................#  
 #####..........................................................................................#  
     #..........................................................................................#  
     #..........................................................................................#  
     #..........................................................................................#  
     #..........................................................................................#  
     #..........................................................................................#  
     #..........................................................................................#  
     #..........................................................................................#  
     #..........................................................................................#  
     #..........................................................................................#  
     #..........................................................................................#  
     #..........................................................................................#  
     #..........................................................................................#  
     #..........................................................................................#  
     #..........................................................................................#  
     #..........................................................................................#  
     #####################......................................................................#  
                         #......................................................................#  
                         ###################....................................................#  
                                           #....................................................#  
                                           #....................................................#  
                                           ######################################################  

